0	0	0	0	0	0	0	0	0	0	0	0	0	0	0	0	0	0	0	0	0	0	0	0	0	0	0	0	
0	2	2	2	2	2	2	2	2	2	2	2	2	0	0	2	2	2	2	2	2	2	2	2	2	2	2	0	
0	2	0	0	0	0	2	0	0	0	0	0	2	0	0	2	0	0	0	0	0	2	0	0	0	0	2	0	
0	3	0	0	0	0	2	0	0	0	0	0	2	0	0	2	0	0	0	0	0	2	0	0	0	0	3	0	
0	2	0	0	0	0	2	0	0	0	0	0	2	0	0	2	0	0	0	0	0	2	0	0	0	0	2	0	
0	2	2	2	2	2	2	2	2	2	2	2	2	2	2	2	2	2	2	2	2	2	2	2	2	2	2	0	
0	2	0	0	0	0	2	0	0	2	0	0	0	0	0	0	0	0	2	0	0	2	0	0	0	0	2	0	
0	2	0	0	0	0	2	0	0	2	0	0	0	0	0	0	0	0	2	0	0	2	0	0	0	0	2	0	
0	2	2	2	2	2	2	0	0	2	2	2	2	0	0	2	2	2	2	0	0	2	2	2	2	2	2	0	
0	0	0	0	0	0	2	0	0	0	0	0	2	0	0	2	0	0	0	0	0	2	0	0	0	0	0	0	
1	1	1	1	1	0	2	0	0	0	0	0	2	0	0	2	0	0	0	0	0	2	0	1	1	1	1	1	
1	1	1	1	1	0	2	0	0	2	2	2	2	2	2	2	2	2	2	0	0	2	0	1	1	1	1	1	
1	1	1	1	1	0	2	0	0	2	0	0	0	1	1	0	0	0	2	0	0	2	0	1	1	1	1	1	
1	1	1	1	1	0	2	0	0	2	0	1	5	1	1	7	1	0	2	0	0	2	0	1	1	1	1	1	
1	1	1	1	1	0	2	2	2	2	0	1	6	1	1	8	1	0	2	2	2	2	0	1	1	1	1	1	
1	1	1	1	1	0	2	0	0	2	0	1	1	1	1	1	1	0	2	0	0	2	0	1	1	1	1	1	
1	1	1	1	1	0	2	0	0	2	0	0	0	0	0	0	0	0	2	0	0	2	0	1	1	1	1	1	
1	1	1	1	1	0	2	0	0	2	2	2	2	2	2	2	2	2	2	0	0	2	0	1	1	1	1	1	
1	1	1	1	1	0	2	0	0	2	0	0	0	0	0	0	0	0	2	0	0	2	0	1	1	1	1	1	
0	0	0	0	0	0	2	0	0	2	0	0	0	0	0	0	0	0	2	0	0	2	0	0	0	0	0	0	
0	2	2	2	2	2	2	2	2	2	2	2	2	0	0	2	2	2	2	2	2	2	2	2	2	2	2	0	
0	2	0	0	0	0	2	0	0	0	0	0	2	0	0	2	0	0	0	0	0	2	0	0	0	0	2	0	
0	3	0	0	0	0	2	0	0	0	0	0	2	0	0	2	0	0	0	0	0	2	0	0	0	0	3	0	
0	2	2	2	0	0	2	2	2	2	2	2	2	2	2	2	2	2	2	2	2	2	0	0	2	2	2	0	
0	0	0	2	0	0	2	0	0	2	0	0	0	0	0	0	0	0	2	0	0	2	0	0	2	0	0	0	
0	0	0	2	0	0	2	0	0	2	0	0	0	0	0	0	0	0	2	0	0	2	0	0	2	0	0	0	
0	2	2	2	2	2	2	0	0	2	2	2	2	0	0	2	2	2	2	0	0	2	2	2	2	2	2	0	
0	2	0	0	0	0	0	0	0	0	0	0	2	0	0	2	0	0	0	0	0	0	0	0	0	0	2	0	
0	2	0	0	0	0	0	0	0	0	0	0	2	0	0	2	0	0	0	0	0	0	0	0	0	0	2	0	
0	2	2	2	2	2	2	2	2	2	2	2	2	2	2	2	2	2	2	2	2	2	2	2	2	2	2	0	
0	0	0	0	0	0	0	0	0	0	0	0	0	0	0	0	0	0	0	0	0	0	0	0	0	0	0	0	
